111111111111111
1000000000001111
1000000000000001
10001000000M0001
1000000000000001
1000000000000001
1000000000000001
1000000000000001
100000N000001001
1000000000001111
1000000000000001
1000000000000001
1000000000000001
1000000000000001
1000000000000001
1111111111111111
