F 82,80,85
C 140,138,142

NO assets/textures/lab1.xpm
SO assets/textures/lab2.xpm
WE assets/textures/lab3.xpm
EA assets/textures/lab4.xpm


     111111111111111           11111
     10000000001111          11000111
     111000011111001         100000001
     1000000000000011111    100000000011
11111111111000001111100111111000000000001
10000000011000001110000000101000000000011111
11110111111111011100000100000000000000000001
11110111111111011101000111111111111111111011
110000001101010111000001                101
100000000000000011000001111             101
100000000000000011010000001             101
110000011100010111110111111             101
1111011111101011111001                  101
1000000000000000000001                  101
1000000111010000000001111111111111111111101
10000010000010000000000000000000S0000000001
1111111100011111111111111111111111111111111
       11111
       11111
