NO assets/textures/ice.xpm
SO assets/textures/lava.xpm
WE assets/textures/bricks.xpm
EA assets/textures/leaves.xpm

F 101,183,65
C 123,211,234




1111111111
100000S001
1000000001
1000000001
1111111111

1111111111
1001000001
1001110101
1000010101
1000010101
1000000001
1111111111